snow
25
21 21
.........|...........
.........|.........o.
.........9--1........
............|........
............|........
..........3-7........
..........|..........
..........|..........
..........|..........
.....o....91......o..
...........91........
............91..oooo.
.............91......
..............91.....
-----1.........91....
.....91.........|....
.o....91........9--1.
.......91..........|.
........91.........|.
.........|.........|.
.........91........|.
right 3 3
right 3 17
eof
