sand
visible
20
20
12 10
...oo...|...
...o..3-7...
.....37o....
.ooo.91o.ooo
..xox.|o....
--1ooo|o....
..9---7o..3-
.....ooo.o|.
.oo....3--7.
.......|....
down 7 1
eof