magma
15
12
24 17
ooooooooooo|oooooooooooo
o.........o9-1.........o
o.........ooo|.........o
o..x.........|......x..o
o............|.........o
o...........o|.........o
o..o......ooo9-1.ooooooo
...oo....x.....|.o......
...oo.....ooo3-7.o......
o.......o.o..|...o....oo
o.......ooo..|...ooooooo
o.......o..3-7.........o
o..........|.oooo......o
o..x.......|........x..o
o..........|...........o
o..........|...........o
ooooooooooo|oooooooooooo
left 13 7
eof