space
visible
22
11
36 20
..............................|.....
...............ooooooooooo....|.....
..............................|.....
............................o.|.....
....o.o.......................91....
..ooo.o....o...o...ooo...o...o.|....
-1....o...o..o...............ox9-1..
.|ooooo...o..................ooo.|..
.9----1....oo......o.o...........91.
......|........o..oo.oo..o....o...9-
......|..3---1.o.........o...ooo....
......9--7ooo|.o..oo.oo..o....o.....
...........o.|.....o.o..............
....ooo....o.9-1.....3---1...ooooo..
.....xo........9-1...91..91..o......
......o........o.|.ooo|..o|..o.ooo..
.................9-1.37...91.o.o....
...................9-7.....9-1......
.............................9-1....
...............................|....
up 21 10
down 21 12
left 20 11
right 22 11
eof