psychogwak
visible
12
20
20 21
...ooooooooooooo....
....................
---1...........3----
..x|...........|x...
...|.....o.....|....
...9----ooo----7....
.......o.|.o........
......o..|..o.......
.....o.3-7...o......
....o..|.x....o.....
...o...|.......o....
..oo...|.......oo...
.ooooooooooooooooo..
....................
...ooooooooooooo....
...o...........o....
...o...........o....
...o.....x.....o....
...o...........o....
...o...........o....
...ooooooooooooo....
right 1 2
eof