grass
visible
22
8
42 22
oooooooooooooooooooooooooooooooooooooooooo
o.................o....o.................o
o.................o....o.................o
o.................o....o.................o
ooooo................................ooooo
o........................................o
o........................................o
o........................................o
ooooox...x...x...x...x...x...x...x...ooooo
o.....x.x.x.x.x.x.x.x.x.x.x.x.x.x.x.x....o
o......x...x...x...x...x...x...x...x.....o
o........................................o
o........................................o
o........................................o
o................o.oooo.o................o
o.............o..o....o.o..o.............o
o.............o..o.o....o..o.............o
oooo..........o..o.oooo.o..o..........oooo
o3-1..........o............o..........3-1o
o|.|..........o..o.oooo.o..o..........|.|o
o9-7..........o............o..........9-7o
oooooooooooooooooooooooooooooooooooooooooo
right 3  3
right 3  7
down  21 3
left  40 3
left  40 7
eof
