psychogwak
visible
10
6
55 11
.........................................................
..oooooo...o.....o....o....o.ooooo..ooo.ooooo.ooo..ooo...
....o....o.o.....o..o.oo...o.o....o.o.....o...o...o...o..
....o....o.o..o..o..o.o.o..o.o....o.oo....o...oo..o---o..
....o....o.o..o..o..o.o..ooo.ox...o.o.....o...o...o...o..
....o....o..oo.oo...o.o...oo.ooooo..ooo...o...ooo.o...o..
.........................................................
..........|......3--1...|................................
..........|......|..|...|..........oooo..................
..........|......|..|...|............xo..................
..........9---...9--7...9---..........o..................
up 19 9
up 20 9
eof
