sand
visible
20
12
30 30
-----------------------------1
...o........o.....o...o.....x|
3--------------------------1.|
|....o....o.......o...o....|.|
|.3----------------------1.|.|
|.|.....o....o......o....|.|o|
|o|.3------------------1.|o|.|
|.|.|....o.....o...o...|.|.|.|
|.|.|.3--------------1.|.|.|o|
|.|.|.|x......o......|.|o|.|.|
|o|.|o|.3----------1.|.|.|.|.|
|.|.|.|.|.o.....o..|.|o|.|.|o|
|.|o|.|.|.3------1.|.|.|.|.|.|
|.|.|.|o|.|..o...|.|o|.|o|o|.|
|o|.|o|.|.|.3--1.|.|.|.|.|.|.|
|.|.|.|.|.|.|.x7.|o|o|.|.|.|o|
|.|.|o|.|.|o|....|.|.|.|o|.|.|
|.|.|.|.|.|.9----7.|.|.|.|.|.|
|o|o|.|o|o|...o....|.|o|.|o|.|
|.|.|.|.|.9--------7.|.|.|.|o|
|o|.|.|.|..o......o..|.|o|.|.|
|.|.|.|.9------------7.|.|.|.|
|.|o|.|..o..o...o....o.|.|o|.|
|.|.|.9----------------7.|.|o|
|o|.|x...o...o.....o..o..|.|.|
|.|.9--------------------7.|.|
|.|.o....o....o....o..o...x|.|
|.9------------------------7o|
|.o....o.......o.....o..o....|
9----------------------------7
right 1 1
down 30 1
left 30 30
eof

