sand
12
10
20 21
oooooooo|ooooooooooo
o.......|..o.......o
o.......|..o.......o
o.......|..o...x...o
o.....3-7..o.......o
o....x|....oooo..ooo
......|........oo...
...o..|.............
...o..|....o........
...o..9-1...oooo....
........|...........
........|....ooooo..
o.ooooo.91...o...ooo
..o....o.9-1.o......
..o....ooo.|.o......
..o...x..o.|.oooo...
o.o......o.|.....ooo
...o...ooo.|........
....ooo.3--7........
........|...........
oooooooo|ooooooooooo
down 9 2
eof