20
20
5
5
RIGHT
15
15
LEFT
oooooooooooooooooooo
o........|.........o
o........9--1......o
o...........|......o
o...........|......o
o.........3-7......o
o.........|........o
o.........|........o
o.........|........o
o....o....91.....o.o
o..........91......o
o...........91..oooo
o............91....o
o.............91...o
o..............91..o
o...............|..o
o...............9--o
oo.................o
o................3-o
o................|-o
oooooooooooooooooooo
